我被电梯带到我不打算去的楼层	电梯	T
是小屋里的人死了	山顶	F
女儿收到律师函因为欠债	日记	F
我遇到的麻烦是我永远不会回来	伪造	F
老婆发现他和闺蜜有染	闺蜜	T
我被分尸了	电梯	N
电梯坏了我被困在里面	电梯	F
我恐高	阳台上的女孩	N
我疯了	伪造	F
老板在我买零食之后被杀了	打折的零食	N
托马斯认识闺蜜	闺蜜	T
我被迫说1237	1237	F
男人不知道汤有毒	海龟汤的故事	N
他考试不及格了	隧道	F
盲人侏儒被马戏团开除了	马戏团	F
陌生人在我家	丢失的手机	T
洗衣机的主人想把洗衣机带走	洗衣机	F
女儿侵犯别人名誉了	日记	T
尸体是邻居	小红裙	F
男生确实死了,在女生学校里做解剖道具	条件	T
他死后尸体被别人放在路上	死刑犯跟恶魔	F
渔夫说的话撒谎了	水草	F
婆婆是午夜出生的	午夜列车	N
老婆跟托马斯离婚的原因跟闺蜜有关	闺蜜	T
有人想嫁祸给拾荒者	洗衣机	F
托马斯知道闺蜜住哪	闺蜜	T
网友在偷窥我	交换照片	T
电梯外有可疑的人	电梯	T
红裙是求救信号	小红裙	F
在隧道里发病了	隧道	F
托马斯真的是第一次见到闺蜜	闺蜜	F
这个案件涉及灵异事件	电梯	F
电梯上升到最顶楼	电梯	F
他看新闻发现小卖部店主在昨天已经死亡了	打折的零食	T
托马斯暴露了某种习惯	闺蜜	T
男生是鬼	水草	N
和女儿聊天的其实并不是身边朋友	日记	T
是狼敲的门	山顶	F
画中人的样子改变了	一幅画	T
半根火柴是男子坠落后弄断的	半根火柴	F
盲人侏儒在马戏团的工作是走独木桥	马戏团	N
画动了	一幅画	F
有第二个人	马戏团	T
电梯上升与按钮不一致	电梯	F
有人贩子在楼上	电梯	F
男子知道自己的死亡时间在五分钟后	午夜列车	F
木屑是盲人侏儒造成的	马戏团	F
房间只有我一个人	数数	N
男子从热气球上摔下来	半根火柴	T
婆婆在69岁死亡	午夜列车	T
那句话只有我能看到	视力	F
我参加了母亲的仪式	仪式	F
新闻内容是通缉男子	新闻	F
愿望的代价跟气味有关	死刑犯跟恶魔	F
他见到了怪物	隧道	F
我父亲杀人了	小红裙	T
木屑在屋子里	马戏团	T
开销大是因为网费或电费	日记	F
洗衣机有自动启动程序	洗衣机	F
两人数的是同一个东西	数数	T
有人在我家	丢失的手机	T
我的伙伴死了	鱼	T
有人杀了男子	半根火柴	T
男子是意外死亡的	半根火柴	F
男人杀了女人然后伪造女人的死因	伪造	T
他点火柴和热气球有关	半根火柴	T
死刑犯许愿空气是臭的	死刑犯跟恶魔	F
有其他人用了拾荒者的洗衣机	洗衣机	T
我走错电梯了	电梯	F
网友活着	交换照片	T
四岁并不是四岁而是进行了四年的什么东西的意思	四岁的妈妈	T
小红裙是这个尸体的	小红裙	F
我感到害怕	一幅画	T
热气球还在飞	半根火柴	N
盲人侏儒以为自己在长高,不能继续工作然后自杀了	马戏团	T
我看到的鱼是普通的鱼	鱼	T
我伪造不出一个人的字迹	伪造	T
女孩不是在和我打招呼	阳台上的女孩	T
电梯要进来人了	电梯	T
写的这几句话是同一个人写的	伪造	T
妈妈不开心	仪式	N
跟车上的人对话之后男子知道自己在几岁死去	午夜列车	T
画中男人是是活人	一幅画	T
老婆发现了什么	闺蜜	T
这段话是情侣之间的对话	伪造	F
新闻报道了鬼屋	新闻	F
我家阳台有脏东西	阳台上的女孩	F
海龟汤和他想象的不一样	海龟汤的故事	T
盲人的拐杖短了	马戏团	N
照片里的其他东西有异常	交换照片	T
小明按不到部分电梯按键	十八楼	T
这人的病是真的全都好了	隧道	T
我因为红裙躲过被杀	小红裙	F
男子得到预言车上婆婆70岁的时候列车会出事故	午夜列车	F
姐姐故意给我挑的红裙子	小红裙	F
我还活着	阳台上的女孩	T
盲人不是真的侏儒	马戏团	F
那件被剪碎的连衣裙是那个女人身上穿的那一套么	粉色连衣裙的女人	T
画上男子的脸会动	一幅画	F
盲人想长高	马戏团	F
他自杀是因为他以为火车要爆炸了	隧道	F
小孩感到惊恐的原因和小王一样	滑梯	T
婆婆的年龄会带来不好的事	午夜列车	F
尸体是爸爸	小红裙	F
画里的人前后有变化	一幅画	T
女生考试作弊	条件	N
闺蜜和老公有一腿	闺蜜	T
这个女人就是邻居本人	粉色连衣裙的女人	T
我是否惹恼了写字的人	伪造	F
托马斯的东西在闺蜜家	闺蜜	F
父母大惊失色是因为他们儿子的女友是我	见家长	T
他是从附近悬崖掉下来的	半根火柴	F
我和男友有血缘关系	见家长	T
洗衣机里有尸体	洗衣机	F
我其实是男友的亲生妹妹	见家长	T
她所说的妈妈是被拐来的	四岁的妈妈	T
老婆在闺蜜家发现了什么东西	闺蜜	T
这些话是我自己写的	伪造	T
女儿利用网络做了坏事	日记	T
电梯出了事故	电梯	F
他能按但是没按	十八楼	F
父母出门后是去同一个地方	仪式	F
男子的家人上新闻了	新闻	F
死者是踩空了	半根火柴	F
其他人启动了洗衣机	洗衣机	T
我也说1237是被洗脑了么	1237	F
留言的人死了	伪造	F
老婆发现闺蜜和丈夫之前认识	闺蜜	T
小朋友没有父母	四岁的妈妈	N
小朋友所谓的妈妈在家	四岁的妈妈	T
小明是有意为之	十八楼	F
男人是被杀死的	半根火柴	T
女士很爱穿高跟鞋	高跟鞋	N
小卖部当时里面有杀人犯	打折的零食	T
新闻报导男子工作的地方出事了	新闻	F
红裙是姐姐买的	小红裙	T
红裙的颜色是被血染红了	小红裙	F
故事里有第三个人	阳台上的女孩	F
木屑是他自己制造的	马戏团	F
我伤害了别人	伪造	T
我看到的不是正常的鱼	鱼	F
他被吓傻和零食本身有关	打折的零食	F
有人提前布置好了他家	马戏团	T
画里的东西是真的人脸	一幅画	T
他不是第一次来隧道	隧道	F
男子模仿妻子	伪造	T
我是被迫去当水手的	鱼	N
托马斯知道闺蜜家在几楼	闺蜜	T
小卖部的老板在我买零食的时候已经遇害了	打折的零食	T
网友能看到我	交换照片	T
说这句话的人精神出现了问题	伪造	F
列车上时间故障了	午夜列车	F
木屑是盲人自己造成的	马戏团	F
信是我认识的人给我的	伪造	F
男人死了不久	半根火柴	F
脸色惨白和该男子的年龄有关	午夜列车	F
她妈妈的生日在七月	1237	N
除了我还有其他人	电梯	T
小朋友说的是实话	四岁的妈妈	F
他的病必须见光	隧道	F
电梯上升的时候有人进来了	电梯	F
他发现自己不是盲人	隧道	F
死刑犯的愿望是尸体味道很大	死刑犯跟恶魔	F
十五到十八楼有什么事情需要小明做	十八楼	F
尸体穿的红色衣服	小红裙	F
这个所谓不会回来的人和遇到麻烦的我是两个人	伪造	T
新闻的内容跟这批零食是什么有关	打折的零食	F
是因为有时候电梯不运行到18楼	十八楼	F
男子是从沙丘上坠落的	半根火柴	F
女人是假扮的	粉色连衣裙的女人	T
我再进阳台会遇到危险	阳台上的女孩	F
男生不是以学生身份和女生进入同一所大学的	条件	T
456和谐音有关	1237	F
女生疯了的原因是不堪忍受男生持续不断的骚扰	条件	F
男人自杀是因为喝了海龟汤	海龟汤的故事	T
女儿不是我女儿	日记	F
死刑犯要求自己的尸体迅速消失	死刑犯跟恶魔	F
男子抽中了跳热气球的签所以为了减重被其他人推下来	半根火柴	T
我吓了一跳的原因是找到的地方让我吃惊	丢失的手机	T
盲人侏儒试图增高	马戏团	F
遇到的麻烦是可能杀人会被发现	伪造	T
我是盲人政府所认为的异类	视力	T
老婆发现丈夫出轨	闺蜜	T
母亲被骗了	仪式	F
洗衣机启动导致了人的死亡	洗衣机	F
对方死了,这些话是死前电话里说的	伪造	F
闺蜜家发生的事让老婆不开心	闺蜜	T
我已经毕业了不用去上学	电梯	F
我不喜欢上学	电梯	F
死者是他杀	小红裙	T
故事有两个人	伪造	T
昨晚男人家中还有其他人	粉色连衣裙的女人	T
有其他人	十八楼	N
他杀了对方这样就可以不用离开他也可以永远在一起了	伪造	F
小朋友所谓的妈妈有遭遇过不好的事情	四岁的妈妈	T
热气球坠落了	半根火柴	F
鱼救过我	鱼	T
尸体是我的亲属	小红裙	F
渔夫告诉男生一些信息	水草	T
我感到害怕和他的照片内容有关	交换照片	T
那晚邻居家还有别人	粉色连衣裙的女人	T
男子的世界一直在循环	午夜列车	F
数字是月份	1237	T
托马斯和闺蜜之前有过偷情	闺蜜	T
母亲想帮助父亲	仪式	F
新闻提到了男子的公司	新闻	F
婆婆活不到70岁	午夜列车	T
女儿6月买东西了	日记	T
木屑不是人为的	马戏团	F
我看到了杀人	电梯	T
高跟鞋导致身高变化	高跟鞋	T
他是心理有病	隧道	F
我看到的话是盲人写的	视力	F
男友是我的亲哥哥	见家长	T
我亲生父母见过男友本人	见家长	T
十八楼不是固定存在的	十八楼	F
文字是我伪造的	伪造	T
这份笔记是一个传递给另一个人	伪造	F
家里人不让小明直接上来	十八楼	F
他这个汤和之前吃的人肉味道不一样	海龟汤的故事	T
她妈妈不会数456	1237	F
他害怕隧道	隧道	F
70岁的人会对男子有危险	午夜列车	F
小朋友全家只有四根手指	四岁的妈妈	F
小朋友真的觉得自己的妈妈只有四岁	四岁的妈妈	F
电梯顶部有尸体	电梯	F
这人病复发了	隧道	F
被杀人犯看到了我	电梯	T
是类似于俄罗斯转盘的死亡游戏	数数	F
托马斯去过闺蜜家	闺蜜	T
妻子真的永远离开了	伪造	T
男子的朋友或者同事出事情了	新闻	F
父母吵架的原因与钱有关	仪式	F
我模仿别人的字	伪造	T
渔夫提到了男生的故人	水草	F
女儿收到律师函导致家里开销大	日记	F
如果我把消息告诉大家我会再度变成盲人	视力	F
婆婆的死亡和男子有关	午夜列车	F
男人发现海龟汤跟记忆中的一样	海龟汤的故事	F
盲人家是木头搭建的	马戏团	N
男友知道父母不会同意	见家长	F
我和男朋友父母其实是没见过面的亲戚但他父母见过我的照片	见家长	N
鱼吃了同伴	鱼	T
小红裙上面是血迹	小红裙	F
女儿因为花了我的钱收到律师函	日记	F
小朋友所谓的妈妈还活着	四岁的妈妈	T
卖货者杀了小卖部原有的老板	打折的零食	T
列车已经脱轨了	午夜列车	F
我如果不穿小红裙是不是不会有人死	小红裙	T
红白喜事我穿了小红裙导致家里有人去世了	小红裙	F
是不是有人为了让他放弃某样东西而布局	马戏团	T
男子工作的地方出事了	新闻	T
看到那句话的人会死	视力	F
我看到了威胁我的话	视力	F
我当水手前也害怕鱼	鱼	N
这个人的字迹越来越潦草了	伪造	N
这人受了刺激	隧道	T
他欠了一屁股债	隧道	F
因为说出这句话会让所有人再次变成盲人	视力	F
婆婆很害怕男子	午夜列车	N
楼上的人按了电梯	电梯	T
根据老婆婆的话她推断出来老婆婆是她认识的人了	午夜列车	F
手机找到了但不是我的	丢失的手机	F
他捡洗衣机被人发现了	洗衣机	T
鞋坏了	高跟鞋	F
我家人出事了	电梯	F
他是因为在热气球上面抽签被人推下来的	半根火柴	T
他妈妈想让老师关注他	1237	F
敲门声是坠落声	山顶	F
故事出现了第二个人	高跟鞋	T
马戏团有两个侏儒	马戏团	T
这是他为自己点的最后的晚餐	海龟汤的故事	F
他在隧道里遇到了医生	隧道	F
这些话是我先对别人说对方又对我说	伪造	F
盲人侏儒打算变高	马戏团	F
我也是他们的孩子	见家长	T
打折的零食真的是零食	打折的零食	T
我从出生开始一直对鱼感到害怕	鱼	F
小王知道自己可能会遭遇不测	滑梯	F
病床没有456号	1237	N
小朋友帮着拐骗幼儿园老师	四岁的妈妈	T
我在模仿电视或者电影里的故事	伪造	F
我曾经被作为鱼饵	鱼	F
男子能看到每个人的年龄	午夜列车	F
家里还有其他人	洗衣机	T
火柴是否被点燃过	半根火柴	F
男子有读心术知道奶奶马上要死了	午夜列车	F
门是朝外开的	山顶	T
他看见自己去看病了	隧道	F
男生的女朋友是在这里死的	水草	T
他之前坐过火车	隧道	N
我遇到了情感问题	伪造	N
手机被人用过	丢失的手机	T
电梯上升过程中除了我有别人	电梯	F
有人偷用他的洗衣机	洗衣机	T
该男子的超能力和婆婆相关	午夜列车	F
他曾住过老婆的闺蜜家	闺蜜	T
是有人闯祸了	伪造	T
我是从小就害怕鱼	鱼	F
尸体只有晚上才出现	小红裙	F
这是小朋友的恶作剧	四岁的妈妈	F
热气球没火了摔死的	半根火柴	F
离婚是托马斯的问题	闺蜜	T
男友和我是一家人	见家长	T
有人来偷东西	洗衣机	F
粉红连衣裙和长发是男人剪碎的	粉色连衣裙的女人	F
婆婆70岁的时候男子会死掉	午夜列车	F
她妈妈不会正确的数数	1237	F
在海上经历一些事情最后吃鱼存活	鱼	T
画是窗户	一幅画	T
实际并不是人像画	一幅画	T
我的麻烦跟文字有关	伪造	T
父亲不在家	小红裙	F
我穿红裙导致了他的死亡	小红裙	T
女子如果不穿这双高跟鞋就可能不会死	高跟鞋	T
我的脸有不正常的地方	见家长	F
母亲挥手是自愿的	仪式	T
小朋友的心理年龄五岁但实际上已经很大了	四岁的妈妈	F
他喝汤的时候周围有别人	海龟汤的故事	N
男子工作的地方发生了事故	新闻	T
母亲转账是为了购买什么东西	仪式	T
姐姐是故意让我穿红裙的	小红裙	F
他怕黑	隧道	F
托马斯勾引闺蜜	闺蜜	F
家访发现孩子七月过生日	1237	T
他是自愿自杀的	隧道	T
有人杀了她	高跟鞋	T
卖他零食的人不是真正的收银员	打折的零食	T
女儿做的事和妈妈有关	日记	F
故事有人死亡	仪式	F
男子遇到了杀人犯	新闻	F
那是窗户	一幅画	T
数数是在倒计时	数数	F
凶手启动洗衣机是为了抽水	洗衣机	F
男友的家庭实际上是跟我有血缘关系	见家长	T
我的手机被除我之外的人或物打开了	丢失的手机	T
他不认识数字	十八楼	F
我喜欢女孩	阳台上的女孩	N
是敲门的人死了	山顶	T
我看到的鱼是真的鱼	鱼	T
热气球负载太重他被人推下来了	半根火柴	T
同伴给他喝过海龟汤和他现在喝的海龟汤味道不一样	海龟汤的故事	T
母亲转账是自愿的	仪式	T
男人能看见别人的寿命这个婆婆满七十岁死亡	午夜列车	F
托马斯连上wifi了	闺蜜	T
卖货者是无良商家	打折的零食	N
女生不想做他女朋友	条件	F
他老婆发现了托马斯来过闺蜜家	闺蜜	T
男友父母见过我本人	见家长	T
短信是家人发的	伪造	F
我出事了	电梯	T
他意识到自己并不是瞎子	隧道	F
火柴点燃了某物	半根火柴	F
托马斯手机里有闺蜜电话	闺蜜	N
我吃过鱼肉	鱼	T
他开门时候门把敲门的人给打到山下摔死了	山顶	T
姐姐还活着	小红裙	T
小红裙是偷情暗号不小心穿上了结果被爸爸杀了	小红裙	T
侏儒想上吊	马戏团	F
从滑梯上滑下来的过程很吓人	滑梯	F
男人能看到老太婆70岁死	午夜列车	F
上升的电梯里有杀人犯	电梯	F
他在数人头	数数	F
第十八层的电梯门是没问题的	十八楼	T
女子有过精神疾病史	条件	N
政府要把恢复视力的人送进实验室	视力	T
4岁是指妈妈来到这个家的年数	四岁的妈妈	T
他曾经把别的食材做的汤误以为是海龟汤	海龟汤的故事	T
我们在捉迷藏躲起来数数,他同样在数数	数数	F
男人的工作和年纪有关	午夜列车	F
托马斯认识老婆的闺蜜	闺蜜	T
老婆闺蜜是托马斯的前女友	闺蜜	F
男子在鬼屋工作	新闻	T
女孩是定时玩偶	阳台上的女孩	F
男子看到了死去的人	新闻	T
同学死了	小红裙	F
男子是死后被抛尸的	半根火柴	F
她妈妈记忆错乱	1237	F
妈妈是说不出这几个数字	1237	F
男子曾经在高处被绑起来过	半根火柴	F
那不是洗衣机的声音	洗衣机	F
我看见的画没有变	一幅画	F
画中的男子是真的画出来的	一幅画	F
他开门的时候意识清醒	山顶	N
老婆其实是同性恋	闺蜜	F
手机是不是丢在没去过的地方	丢失的手机	F
托马斯做了错事	闺蜜	T
女孩真的是在打招呼	阳台上的女孩	F
男生把水里的人当成别的东西而没成功救人	水草	T
隧道有问题	隧道	F
是因为东西被剪碎了而争吵	粉色连衣裙的女人	F
第二天看到的画才是真的画	一幅画	F
托马斯之前来过老婆闺蜜家	闺蜜	T
男子乘坐热气球时掉下来的	半根火柴	T
男生考试超常发挥	条件	F
男子提前回家了	新闻	F
木屑是拐杖	马戏团	F
售货员是杀人犯	打折的零食	T
他的尸体附近有其他物品或痕迹表明他曾尝试生火	半根火柴	F
汤让他想起了什么	海龟汤的故事	T
我看到了一个尸体	四岁的妈妈	F
开门把人推下去了	山顶	T
画中的人物是真实存在的	一幅画	T
她被自己的鞋跟杀死了	高跟鞋	F
昨晚画中是真人	一幅画	T
这个尸体是我认识的人	小红裙	T
我一整天都在家	丢失的手机	F
小明不住18楼	十八楼	F
456不能提起	1237	F
他是镜像	数数	F
女儿的行为跟上学或放假有关	日记	F
1237和他家里的东西有关	1237	F
男友是我爸妈的孩子	见家长	T
卖东西的人有可能不知道价格	打折的零食	T
男生是通过成绩以外的方式进入大学的	条件	T
他所看到婆婆的寿命只有69	午夜列车	T
高跟鞋是记号引起误会被杀	高跟鞋	F
男生偷偷溜进学校	条件	F
突然电梯的灯灭了	电梯	F
是有人操作电梯让电梯上升	电梯	T
小朋友是故意的	1237	F
热气球漏气了	半根火柴	F
数字是年龄	1237	F
学校在地下室	电梯	F
这个故事里死的人数是一个或以上	电梯	T
男子是从悬崖上掉下来的	半根火柴	F
对面楼废弃了	阳台上的女孩	F
婆婆也有超能力	午夜列车	N
他的死亡是不是与别人有关	马戏团	T
我看到电梯里有人死了	电梯	F
洗衣机是死人启动的	洗衣机	F
死的人是学校里的人	小红裙	T
我本来要死	小红裙	F
男子看见人头上有字	午夜列车	N
他们三个互相之前都认识	闺蜜	T
气味来源是活物	死刑犯跟恶魔	F
男子要找一个70岁的人	午夜列车	F
妈妈的想法很感人	1237	T
他是在数我是第几个要被杀的	数数	F
敲门的不是人	山顶	F
我的手机曾经在别人手上	丢失的手机	T
故事里有第三个人	山顶	F
女士过去表演时不穿高跟鞋	高跟鞋	F
电梯外有人想杀我	电梯	T
整个故事是否有人死	新闻	T
隧道会让他再次得病	隧道	F
他们最后成为情侣了	条件	F
新闻中的事件和男子有关系	新闻	T
他是发现了餐厅喝的这碗汤里有人肉	海龟汤的故事	F
小孩惊恐是因为玩滑梯玩的	滑梯	F
我长大了不用上学了	电梯	F
两个人分手了	伪造	F
火柴是男人行李里的	半根火柴	F
母亲是去见活人	仪式	T
火柴是死后被人放上去的	半根火柴	F
新闻内容报道了男子的工作地点	新闻	F
洗衣机是可以远程控制的	洗衣机	F
死的是穿小红裙的人	小红裙	F
那幅画第二天变得和第一天不一样了	一幅画	T
女孩是尸体被人挂上去的	阳台上的女孩	F
男友有一个妹妹	见家长	T
男子被风刮下来的	半根火柴	F
家里除了小朋友还有人活着	1237	T
是不是曾经吃过人肉	鱼	N
我们阳台很高有栅栏	阳台上的女孩	N
卖给他货的人不是老板	打折的零食	T
我母亲挥舞双手是正常的	仪式	T
我不想去学校	电梯	F
电梯失控	电梯	F
感到恶心是因为鱼太腥了	鱼	F
律师函上写的不是女儿的名字	日记	F
笔迹是我模仿的	伪造	T
母亲转走了父亲的钱	仪式	F
是不是出现电梯意外了	电梯	F
是男人自己的枪	海龟汤的故事	N
女士身高发生变化导致死亡	高跟鞋	T
这些是别人说的话	伪造	F
男子猜错了就会死	午夜列车	F
上升时电梯里有坏人	电梯	F
手机上有让人惊悚的内容	丢失的手机	F
对我失望的人是我的妻子	伪造	F
他今天见到了电视里的死者	新闻	T
新闻内容播报的人是该男子	新闻	F
这个人患有幽闭恐惧症	隧道	F
新政府导致所有人失明	视力	F
他的病真的好了	隧道	T
盲人侏儒吸入了木屑	马戏团	F
裙子的颜色和死因有关系	小红裙	T
男子以为自己能看见别人的年龄但实际上是死亡年龄	午夜列车	F
邻居家昨晚是两个男人	粉色连衣裙的女人	F
男子经历海难的时候喝过假的海龟汤	海龟汤的故事	T
一群人在热气球上面用火柴抽签来决定谁跳下去	半根火柴	T
行李的重量跟男子死亡有关	半根火柴	T
女儿是被冤枉的	日记	F
她妈妈真的是她妈妈	1237	T
是一个精神有问题的人的喃喃自语	伪造	F
男友父母想过让我回到他的家	见家长	T
画中人是假的	一幅画	F
即将有事情发生	午夜列车	T
地球上还有除自己以外的人	视力	T
有人在电梯顶部	电梯	F
男人的死是投票决定的	半根火柴	F
母亲是要去买东西	仪式	F
男生靠其他方式进入那所大学	条件	T
他打开门把敲门的人推下去了	山顶	T
男人死亡是婆婆导致的	午夜列车	F
仪式其实是为了家人而举行的	仪式	F
男生跳河和第三个人有关	水草	T
男生遗体捐献	条件	T
拾荒者是睡在自己的住所	洗衣机	T
男友家里除了父母还有别人	见家长	N
画是玻璃材质的	一幅画	T
女孩没有影子	阳台上的女孩	N
女儿在网上认识的朋友骗了家里的钱	日记	F
男子是死神	午夜列车	F
男子在新闻上看到了死亡的人的照片	新闻	T
男的不见了	一幅画	T
男生变成了尸体	条件	T
女士在夜晚上班	高跟鞋	T
男子没猜对婆婆的年龄	午夜列车	F
女生考的医学院男生是解刨的尸体	条件	T
男人看到婆婆的年纪是70	午夜列车	F
死者敲完门害怕,自己掉下去了	山顶	F
画中的男人是个真的男人	一幅画	T
他的病并没好	隧道	F
他想到了之前的人死了	海龟汤的故事	T
他曾经喝过海龟汤但不是这个味道	海龟汤的故事	T
男子是失足坠落	半根火柴	F
女士的职业重要	高跟鞋	T
母亲是在学习什么东西	仪式	T
盲人第一次知道自己是侏儒	马戏团	F
女儿的行为对明星造成不好的后果了	日记	T
那天晚上是男的和别人争吵	粉色连衣裙的女人	T
以前喝的海龟汤是妻子的肉做的	海龟汤的故事	T
画里的男人其实是在看我的男人	一幅画	T
他看到了不该看到的东西	隧道	F
女孩家有阳台	阳台上的女孩	T
他妻子去世了没有生还	海龟汤的故事	T
闺蜜结婚了	闺蜜	N
男子的身份被新闻揭露了	新闻	F
凶手是因为我去上学所以杀人的	小红裙	F
老四老五老六死了	1237	F
他们发现我和男生长得很像	见家长	N
父亲是去跳广场舞	仪式	F
挥舞双手是在跳广场舞	仪式	T
我给自己的手机打过电话	丢失的手机	T
小明记错了楼层	十八楼	F
家访时我知道了为什么小朋友总说123后面是7	1237	T
这些笔迹不是我写的	伪造	F
有人受到伤害	闺蜜	T
隧道里有声音吓到他了	隧道	F
小朋友妈妈是外观像像四岁	四岁的妈妈	F
这些话是两个人说的	伪造	F
我看见了食人鱼	鱼	F
我被洗脑了	1237	F
小朋友是有意要这么数数	1237	F
我是他们的女儿	见家长	T
那幅画是窗户	一幅画	T
第二天画里的男子不见了	一幅画	T
我是男友的家人	见家长	T
和自己逝世的亲人有关	1237	F
他的超能力和列车有关	午夜列车	F
火柴是用来决定杀谁的	半根火柴	T
死刑犯许愿别人闻不到他的特殊气味	死刑犯跟恶魔	F
小明先到十五楼是因为身高够不到	十八楼	T
他吃完海龟汤心情不好	海龟汤的故事	T
死者把电梯叫上去了	电梯	T
是我杀了那个死亡的人	伪造	T
我最后找到了手机	丢失的手机	T
死者与我家里人有仇	小红裙	F
老婆离婚是情感方面的原因	闺蜜	T
盲人侏儒以为自己竞争不过别人所以自杀了	马戏团	T
她和她闺蜜抓奸了托马斯	闺蜜	F
画中的男子消失了	一幅画	T
我知道鱼的诱饵的成分所以觉得鱼很恶心	鱼	T
男子在电视里看到自己了	新闻	F
妈妈的精神正常	1237	T
是因为这个女孩我不敢再到阳台	阳台上的女孩	T
他的同伴想通过火柴向别人传达一些信息	半根火柴	F
数的是手指	数数	F
我在报警	数数	T
托马斯喜欢老婆	闺蜜	N
老婆出轨了闺蜜	闺蜜	F
小红裙是导致死亡的原因	小红裙	T
小王看到小孩站在那	滑梯	F
死的人和我有关系	小红裙	T
热气球超载	半根火柴	T
这些话是写在纸上的	伪造	T
男人在餐厅喝的这碗海龟汤是人肉做的	海龟汤的故事	F
男人和老婆的闺蜜搞在一起了	闺蜜	T
他在马戏团有竞争对手	马戏团	T
恶魔让死刑犯变成了尸体	死刑犯跟恶魔	F
电梯里有高跟鞋女性	电梯	F
有人企图拿走洗衣机	洗衣机	F
小朋友妈妈死了之后到现在已经过了四年了	四岁的妈妈	F
我是男友父母的亲生女儿	见家长	T
打折零食里面装的是真的零食	打折的零食	T
男子的超能力是识别别人的年龄	午夜列车	F
他可能想害我	数数	T
母亲跟踪父亲	仪式	F
我看到了小朋友家里的情况	1237	T
电梯上升时有人死了	电梯	T
我在现实中见到了画中的男子	一幅画	N
这个声音真的是洗衣机发出来的	洗衣机	T
女儿加入了某种团体	日记	T
她的高跟鞋有质量问题	高跟鞋	F
那个女生跟邻居有亲密关系	粉色连衣裙的女人	F
闺蜜是老婆的亲人	闺蜜	F
网友发送的照片和我拍的照片是同一张	交换照片	T
挥舞双手是跳舞	仪式	T
男子是被人推下去的	半根火柴	T
有其他人看得见这句话	视力	T
电话遗落在家里了但是我是独居	丢失的手机	T
是在工作中发生了意外	马戏团	F
尸体是我家人	小红裙	F
海龟汤里有药导致他自杀	海龟汤的故事	F
我走到哪画中的人都盯着我	一幅画	N
托马斯对闺蜜做出了某些行为导致老婆认为托马斯出轨了	闺蜜	F
女儿转钱是为了购买某个东西	日记	T
火柴是別人放上去的	半根火柴	F
房间里还有其他人	丢失的手机	T
麻烦是警察会来找我	伪造	T
男子抽签抽到最短的火柴	半根火柴	T
死者的死因和我有关	小红裙	T
老婆和闺蜜在一起了	闺蜜	F
摁电梯的人被杀了	电梯	T
死者认识我妈	小红裙	T
他喝过同样味道的汤	海龟汤的故事	F
母亲真的给别人转账了	仪式	T
如果男子猜对年龄列车就会出事	午夜列车	F
男子的工作合法	新闻	T
有人进他的屋子了	山顶	F
恶魔帮助他的代价是从他身上获取一些东西	死刑犯跟恶魔	F
死刑犯的尸体后来被运送出监狱了	死刑犯跟恶魔	F
我回错家了	小红裙	F
他被迫跳下火车	隧道	F
他和她老婆的闺蜜有一腿被他老婆发现了	闺蜜	T
老婆不开心	闺蜜	T
学校发生意外了	电梯	F
听完婆婆的回答其他人也脸色惨白	午夜列车	N
这是海盗船所以水手也是海盗	鱼	F
我见到了那个画里的人	一幅画	N
我的同伴被当成鱼饵了	鱼	T
侏儒做木工活	马戏团	F
女人在是做高空工作的	高跟鞋	F
洗衣机里有人拾荒者听到了他挣扎的声音	洗衣机	F
画中的人是真实存在的	一幅画	T
他是真实的人	数数	T
红色高跟鞋是从死人身上拔下来的	高跟鞋	F
列车方向开反了	午夜列车	N
这辆列车不是真的列车	午夜列车	F
半根火柴是凶手放在他手里的	半根火柴	F
女孩的手臂是真实存在的	阳台上的女孩	T
男子的死亡是否跟第二人有关	海龟汤的故事	T
他原本的病是失忆症	隧道	F
热气球出事了大家抽火柴决定谁跳下去	半根火柴	T
有其他的人来我们家	小红裙	T
新闻里报道的是杀人案	新闻	F
这句话是恋人对我说的	伪造	F
小卖部真正的售货员被凶手杀害凶手假装成售货员而他不知道零食的价格所以卖的便宜	打折的零食	T
闺蜜是托马斯前任	闺蜜	F
女孩是被人摆成打招呼的姿势的	阳台上的女孩	F
我去到了电梯原本没有的楼层	电梯	F
我出海发生过意外	鱼	T
每个人都能看到他死尸的样子	死刑犯跟恶魔	F
画中男人还活着	一幅画	T
画有变化	一幅画	T
昨晚邻居家除了男人还有别人	粉色连衣裙的女人	T
这个人是在背书	伪造	F
我要跳楼	电梯	F
男子脸色惨白是觉得奶奶有点吓人	午夜列车	F
突然停电了	电梯	F
新闻里有恐怖的画面	新闻	F
父亲真的是出去散步	仪式	T
我不认识字	伪造	F
托马斯骚扰闺蜜了	闺蜜	F
男子曾经很绝望	半根火柴	T
男友是我亲哥	见家长	T
电梯故障本来应该下降	电梯	F
尸体是罪犯的	小红裙	F
是我导致电梯上升的	电梯	F
是为了掩盖自己住哪层	十八楼	F
男子遇到困难了	伪造	T
是手机里面的东西吓我一跳	丢失的手机	F
托马斯之前见过老婆闺蜜	闺蜜	T
他在荒岛上经历了什么	海龟汤的故事	T
打开门没有看到死者,于是死者冻死了	山顶	F
行人是否必须经过一个特定的地方才能闻到味道	死刑犯跟恶魔	T
有人会解刨不是盲人的人	视力	T
我之前见过画中的男子	一幅画	F
我可能要死了	电梯	T
他还活着	数数	T
女人工作需要穿高跟鞋	高跟鞋	N
画中人第二天和前一天的样子不一样	一幅画	T
死的人是独自居住在山顶小屋里的人	山顶	F
是人重复发出声音	伪造	F
猜错乘客年龄会有惩罚	午夜列车	F
马上车就要出事故这个男子是困在循环里	午夜列车	F
我被人认成了别人	小红裙	F
是马戏团其他的侏儒导致的	马戏团	T
其实没有隧道是这个人再一次看不见了	隧道	F
18楼是顶楼	十八楼	N
母亲在转账是和别人做交易	仪式	T
他是抱着寻求真相的想法去喝汤的	海龟汤的故事	N
电梯是能到达18楼的	十八楼	T
她会因为身高变高而死亡	高跟鞋	T
她们的争执是因为情感问题	粉色连衣裙的女人	F
新闻里有卖货者	打折的零食	T
女儿眼睛出问题了	日记	N
死刑犯的愿望导致了他的死亡	死刑犯跟恶魔	T
托马斯对闺蜜家熟悉	闺蜜	T
网友发过来的照片是我的照片	交换照片	T
女生疯了是因为学业压力太大	条件	F
男人是缺水而死	半根火柴	F
他在鬼屋工作,道具尸体是真的死了	新闻	T
杀人犯想吓跑流浪汉	洗衣机	F
父亲知道母亲给别人转账	仪式	N
我目睹了杀人现场我报警要说楼层凶手数楼层要杀我	数数	T
是不是有人去过侏儒家	马戏团	T
小红裙有特殊含义	小红裙	T
反对结婚和我的长相有关	见家长	T
婆婆死亡年龄是70	午夜列车	F
死刑犯的尸体完整	死刑犯跟恶魔	N
盲人侏儒的家塌了	马戏团	F
我本来是要坐电梯下楼	电梯	T
小朋友把妹妹称为妈妈	四岁的妈妈	F
照片里面包含我家的部分背景	交换照片	T
我去上学要下楼	电梯	T
凶手杀人分尸跟着拾荒者回家想清理现场	洗衣机	T
女儿玩游戏	日记	F
木屑是盲人侏儒倒地造成的	马戏团	F
托马斯的老婆在她闺蜜家里发现托马斯以前曾和闺蜜的男朋友或老公出轨过	闺蜜	F
有坏人在楼上或楼顶	电梯	T
我在上学的路上看到了尸体	小红裙	F
高跟鞋是凶手的	高跟鞋	F
这个人失去了眼睛在火车经过隧道的时候以为天突然黑了吓得想要逃出火车随即摔死	隧道	F
男士本来可以拯救女生	水草	T
闺蜜老公给闺蜜买东西了	闺蜜	F
住在山顶的人造成了有人死亡	山顶	T
尸体本应该是我	小红裙	F
水草象征着绿帽子	水草	N
他以前来过隧道	隧道	N
他的病并没有好	隧道	F
整个过程中女儿还是原来那个女儿	日记	T
小王不能离开滑梯了	滑梯	F
我真的去上学了	小红裙	T
电梯里有人被杀了	电梯	N
半根火柴是烧断的	半根火柴	F
是我收到的短信	伪造	F
盲人侏儒是做木工的时候死的	马戏团	F
女士穿着高跟鞋工作	高跟鞋	T
他去的小卖部遭遇了抢劫	打折的零食	T
有人死了	条件	T
一个女人永远不会回来了	伪造	T
我模仿着死去的那个人的字迹	伪造	T
男生和之前那个死在河里的人认识	水草	T
男友父母认识我	见家长	T
婆婆是男子的亲人	午夜列车	F
我看到他杀人了但他在数我的楼层	数数	T
零食是合法的	打折的零食	N
男子必须在午夜到来之时猜对所有人的年龄	午夜列车	F
汤里有壳	海龟汤的故事	N
死者在敲门前是否活着	山顶	T
画里是一个人	一幅画	T
小朋友她哥找女老师囚禁	四岁的妈妈	T
火车有问题	隧道	F
热气球马上坠落了必须减重男子抽到了代表被丢出去的半根火柴	半根火柴	T
画里出现了新的东西	一幅画	F
我按的向下的按钮但是电梯向上走了	电梯	F
男的死了成了大体老师	条件	T
女孩挥手是在求救	阳台上的女孩	F
我在陌生的地方找到了手机	丢失的手机	F
卖打折零食的人有问题	打折的零食	T
死刑犯越狱失败了	死刑犯跟恶魔	F
我真的永远也不会回来了	伪造	F
我的手机出现在案发现场	丢失的手机	F
这人病没完全好	隧道	F
女儿捐款了	日记	F
男子害怕过生日	午夜列车	F
妈妈要提前给小女孩过生日	1237	T
敲门声是人摔下去发出的	山顶	F
我不想对方离开于是杀了对方	伪造	F
我被吓到了	一幅画	T
母亲是在学习跳舞	仪式	T
我看到的女孩是鬼	阳台上的女孩	F
电梯按钮无法使用	电梯	F
主人听见敲门声音的时候门外有人	山顶	T
他在模仿妻子字迹	伪造	T
他见鬼了	隧道	F
有人在我面前模仿别人	伪造	F
我在重复地过同一天	伪造	F
高跟鞋断了	高跟鞋	F
母亲想偷偷花钱不让人知道	仪式	F
我的手机现在在别人手上	丢失的手机	F
父亲和母亲出门跳广场舞去了	仪式	F
水手的伙伴不喜欢鱼	鱼	N
敲门时门口有人	山顶	T
说这句话时我还活着	伪造	T
他以为自己不会被继续雇佣了	马戏团	T
他的特异功能在婆婆身上出现了错误的判断	午夜列车	F
盲人侏儒以为自己长高了马戏团不要自己	马戏团	T
托马斯之前就去过老婆闺蜜家	闺蜜	T
别人模仿我的笔迹成功后要处理掉我	伪造	F
我头皮发麻是因为画中的人	一幅画	T
他是士兵	海龟汤的故事	N
大学是医学院	条件	T
数字代表人数	1237	F
死者是敲门的人和小屋里的人之一	山顶	T
母亲转账是用于购买	仪式	T
他正在做木工	马戏团	F
男子是真人在偷窥我	一幅画	T
手机在原地但是被用过	丢失的手机	T
新闻内容有杀人犯	新闻	F
电梯的目的地不是学校	电梯	T
是我自己主动去的家访	1237	T
零食是人肉做的	打折的零食	F
主角被亲人抛弃了	伪造	F
尸体是我亲人	小红裙	F
男人来到餐厅是不是没说话	海龟汤的故事	N
我是女儿的家长	日记	T
穿了小红裙导致别人认为我是其他人	小红裙	F
我是男友父母的孩子	见家长	T
我是私生女	见家长	F
她在马戏团工作	高跟鞋	T
是我写的话	伪造	T
我是男友的姐姐	见家长	F
死刑犯向恶魔许愿的内容是出狱	死刑犯跟恶魔	F
小朋友说的妈妈是画上的人	四岁的妈妈	F
男人是被拥有另外半根火柴的人谋害致死的	半根火柴	F
红色高跟鞋是被杀目标	高跟鞋	F
画中的男子活着	一幅画	T
洗衣机的声音是拾荒者幻听	洗衣机	F
婆婆撒谎了	午夜列车	F
离婚的原因是因为托马斯出轨	闺蜜	T
这个人有幽闭恐惧	隧道	F
男子的行李被别人动过了	半根火柴	F
那是真的画	一幅画	F
他失业了	隧道	F
男子是和行李一起坠落的	半根火柴	F
尸体是被别人杀死后放进来的	小红裙	F
鱼是人作为诱饵钓上来的	鱼	T
婆婆有特殊身份	午夜列车	F
他不开门他自己会死	山顶	F
老婆知道了一些事	闺蜜	T
凶手把电梯叫上去了	电梯	F
男子还活着	新闻	T
海龟汤是否引起了男人对海难的记忆	海龟汤的故事	T
我被退学了	电梯	F
我要去的是太平间	电梯	F
上学不允许穿小红裙	小红裙	F
新政府要杀能看得到的人	视力	T
男人从飞机上坠落	半根火柴	F
如果小女孩穿其他颜色的裙子会出现尸体	小红裙	F
那个婆婆是正常人	午夜列车	T
热气球出故障了	半根火柴	T
男子从事的工作不合法	新闻	F
电梯发生了故障	电梯	F
男人被推下来摔死的	半根火柴	T
他们都要死掉了男的能看到他们活了多久	午夜列车	T
一次看和第二次看是同一个东西	一幅画	F
洗衣机里面是干净的	洗衣机	F
父母吵架是因为母亲的异常	仪式	N
电梯突然停电了	电梯	F
老婆掌握了老公出轨证据	闺蜜	T
水手遇到过海难吃了人肉对外称是鱼肉	鱼	F
新闻内容是关于杀人犯的	新闻	F
罪犯想嫁祸给拾荒者	洗衣机	F
男子上班的时候看到了奇怪的东西	新闻	T
尸体我不认识	小红裙	F
新闻报道说这个男人失踪了	新闻	F
男子是在热气球上点燃的火柴	半根火柴	F
这个男子在找人	午夜列车	F
有人死了	新闻	T
托马斯出轨对象在现场	闺蜜	T
他自杀是因为另一个人	海龟汤的故事	T
我精神有异常	鱼	N
裙子和头发是男人的	粉色连衣裙的女人	T
车上的乘客年龄超过七十岁会发生不好的事情	午夜列车	F
死尸跟小屋里的人有关	山顶	T
马上就要午夜12点了	午夜列车	T
盲人侏儒死亡是因为身高	马戏团	T
是小屋里的人杀了人	山顶	T
妈妈生病了所以不知道456	1237	F
是自然因素导致坠落	半根火柴	F
尸体是我邻居	小红裙	F
画变了	一幅画	T
母亲举行仪式和吵架有关	仪式	F
我后面是被养父母抚养长大的	见家长	T
手机在丢了之后记录了一些东西	丢失的手机	F
网友在求救	交换照片	F
写这些话的人杀人了	伪造	T
他的愿望是让路上变臭	死刑犯跟恶魔	F
是我伪造别人的口吻写的	伪造	T
一个人杀了另一个人想伪造遗书但是怎么都写不好	伪造	T
男人第二天不见了	一幅画	T
洗衣机中有人	洗衣机	F
有人藏在洗衣机里被拾荒者带回家了	洗衣机	F
男人在餐厅喝的真的是海龟汤	海龟汤的故事	T
他是因为看到隧道发病了	隧道	F
邻居本人和连衣裙女人是同一个人	粉色连衣裙的女人	T
高跟鞋很显眼导致她被杀害	高跟鞋	N
发出来的声音不是真正洗衣机的声音	洗衣机	F
我是男友的亲人	见家长	T
女儿请了律师	日记	N
他得癌症了	隧道	F
男子痛恨那家餐厅	海龟汤的故事	N
父母通过女孩脸上的胎记认出了这是之前的弃婴	见家长	F
网友没有露脸	交换照片	T
小明有时候穿增高鞋垫了	十八楼	F
小孩不可以说4	1237	F
第二天男子还在那里	一幅画	F
海龟汤让他意识到了什么	海龟汤的故事	T
托马斯在他老婆闺蜜家里遇到了他老婆的前男友发现他们还保持着联系	闺蜜	F
男子上错了车	午夜列车	N
电梯加速上升之后故障了我被困在电梯里了	电梯	F
托马斯就是闺蜜本人	闺蜜	F
电梯被人按了	电梯	T
女孩掉下去了	阳台上的女孩	F
那句话是说话就又变盲人了	视力	F
车上有人虚报年龄	午夜列车	F
是锯木头声被侏儒误认为成什么了	马戏团	F
每天打招呼的时候女孩已经死了	阳台上的女孩	T
我的养父母和男友父母认识	见家长	T
拾荒者的洗衣机被偷了	洗衣机	F
我是男友的妹妹	见家长	T
他知道枪里有子弹	海龟汤的故事	N
小朋友爸爸娶了个四岁的老婆	四岁的妈妈	F
男子是不小心掉下去的	半根火柴	F
456对妈妈有伤害	1237	F
男子曾经乘坐飞行工具在沙漠上面	半根火柴	T
年龄重要	午夜列车	T
渔夫说的话里提到了某个人	水草	F
恶魔给了这个人特异功能	死刑犯跟恶魔	T
突然一个乘电梯的人转过身来	电梯	F
经过隧道时他感到不舒服	隧道	T
大风撞门造成敲门的声音	山顶	F
男子获得了乘客的信息	午夜列车	F
女人死了	粉色连衣裙的女人	F
小红裙是杀人的信号	小红裙	F
母亲给人转账了	仪式	T
凶手数数与我相关	数数	T
电梯是被楼上的人叫上去的	电梯	T
小王有危险	滑梯	F
闺蜜希望他们离婚	闺蜜	N
店主是坏人假扮的杀了原店主	打折的零食	T
我如果不穿小红裙死者就能活下来	小红裙	T
是海边餐厅	海龟汤的故事	N
两人一起进的学校不是好学校	条件	N
自杀的时候火车停了	隧道	N
是因为电梯不能直接到十八楼	十八楼	F
粉色连衣裙是男人剪碎的	粉色连衣裙的女人	F
女儿是未成年	日记	N
洗衣机启动是因为定时启动	洗衣机	F
红裙子是姐姐的阴谋	小红裙	F
盲人以为自己不能在马戏团工作了	马戏团	T
我杀了妻子伪造证据	伪造	T
有人进来家里了	丢失的手机	T
我本来应该是下楼	电梯	T
男生在高考前夕已经由于意外死亡但是女生在大学里却看见了男生	条件	F
红裙子被杀手盯上了	小红裙	F
我如果今天不去上学尸体会出现	小红裙	F
女儿是被告	日记	T
小朋友和她所谓的妈妈有血缘关系	四岁的妈妈	F
我还活着	小红裙	T
因为运气不好所以他死了	半根火柴	T
小王看到了加班回家的自己	滑梯	T
问题在老婆身上	闺蜜	F
女生疯掉的原因和高考相关	条件	F
第二天画里的男人消失了	一幅画	T
女孩这么数数是为了她自己的安全考虑	1237	F
男生曾经为了救人而跳河	水草	T
让别人知道我恢复视力会被杀	视力	T
曾经有在海上没有别的食物只能吃鱼度过	鱼	F
新闻说男子已经出事死亡了	新闻	F
网友发出的是我家的照片	交换照片	T
漏掉的数字本身和事件关联很大	1237	T
晚饭吃的是正常的晚饭	仪式	T
那是一幅画	一幅画	F
餐厅的海龟汤里的是真的海龟	海龟汤的故事	T
我之前见过这位男子	一幅画	F
争吵是因为女子的穿着打扮而起的	粉色连衣裙的女人	T
粉色连衣裙和长发是我看到的那个女人自己剪的	粉色连衣裙的女人	F
我看到了电梯里的谋杀	电梯	F
在闺蜜家吵架了	闺蜜	F
妈妈会数正确的数	1237	T
另外半根火柴因为坠落熄灭了	半根火柴	F
男子看到自己的通缉令了	新闻	F
男子遇到杀人犯了	新闻	F
第二天画面变了	一幅画	T
照片里有网友本人	交换照片	T
新闻里有杀人犯	新闻	F
天黑看不见路点燃火柴看清路况结果脚下是悬崖然后摔死了	半根火柴	F
我很可能会遭遇不测	小红裙	F
小朋友所说的妈妈是成年人	四岁的妈妈	T
男子见到自己在电视上	新闻	F
电梯上升过程中我被卡在电梯里	电梯	F
有超自然因素	鱼	F
数的数字是她妈妈得病的时间	1237	F
信是我写的	伪造	T
老婆认为他不忠	闺蜜	T
有超自然力量或犯罪事件	一幅画	F
我是因为换衣服发现尸体的	小红裙	F
他病没好	隧道	F
有人离家出走了	伪造	F
脚上有伤口因为鞋是红色的没发现	高跟鞋	N
邻居家深夜真的摔了东西	粉色连衣裙的女人	T
画的内容让我感到恐惧	一幅画	F
我是男友爸妈的女儿	见家长	T
盲人给自己做了个棺材	马戏团	F
他有精神疾病	海龟汤的故事	N
男子曾乘交通工具	半根火柴	T
男人是被人杀的	半根火柴	T
姐姐是为了污蔑我妈	小红裙	F
我是他父母送走的孩子	见家长	T
这人觉得没希望了就自杀了	隧道	T
他要造成他不在18楼的证据	十八楼	F
电梯门打不开	电梯	F
母亲挥舞双手是母亲自己的原因	仪式	T
这人以为自己没治好	隧道	T
我是意外死亡	电梯	F
妈妈是被囚禁的老师	四岁的妈妈	T
手机丢失的时候有人打开过我的手机	丢失的手机	T
恢复视力的人如果被别人知道会被杀掉	视力	T
男子是从悬崖坠落的	半根火柴	F
她妈妈是故意说错	1237	T
老师被别人杀了	小红裙	T
他在数日子	数数	F
小朋友妈妈的智商水平是只有四岁年龄的智商水平	四岁的妈妈	F
闺蜜劝老婆离婚	闺蜜	F
死刑犯死在一个路上没有人能看到他	死刑犯跟恶魔	T
拾荒者自己启动的洗衣机	洗衣机	F
这个人以为自己的病没好	隧道	T
女儿说的好事只是对于她的好事	日记	T
小朋友所说的妈妈是幼师	四岁的妈妈	T
他的死亡是不是与他是侏儒有关	马戏团	T
死刑犯想有超能力	死刑犯跟恶魔	T
这个人怕黑	隧道	F
女儿干了什么所以收到了律师函	日记	T
是马戏团其他的侏儒杀的	马戏团	F
还有五分钟男子就要死了	午夜列车	N
小朋友被家暴了	四岁的妈妈	N
考上了大学女生依旧不愿意跟男生在一起	条件	N
我没有女儿是幻觉	日记	F
画是真的画	一幅画	F
自杀是自愿的	海龟汤的故事	T
男子在飞机上抽到了半根火柴	半根火柴	F
枪是偷来的	海龟汤的故事	N
托马斯偷看老婆闺蜜	闺蜜	N
他成功离开了监狱的原因是他死了	死刑犯跟恶魔	F
是学校的原因导致我无法再去学校了	电梯	F
我和我的男友有亲缘关系	见家长	T
男子的脸消失了	一幅画	T
午夜死亡的人会变成厉鬼索命他知道老太太马上会变鬼杀了他	午夜列车	F
母亲加入了什么社团	仪式	T
他在数楼层足够你跳楼后死亡	数数	F
男友父母还活着	见家长	T
疫情期间女儿被网骗了	日记	F
男生还活着	条件	F
尸体是我	小红裙	F
我写出的笔迹与想象的不一样	伪造	T
现在和我打招呼的是女孩的鬼魂	阳台上的女孩	F
洗衣机是人启动的	洗衣机	T
这些话是他自己写的	伪造	T
男朋友父母不喜欢我	见家长	F
我即将受困	电梯	T
男子有生命危险	新闻	F
老婆闺蜜是托马斯前任	闺蜜	N
我现在危险	数数	T
他曾和同伴一起被困孤岛了	海龟汤的故事	T
男子之前看到了尸体	新闻	T
他跳车自杀是因为太兴奋了	隧道	F
连衣裙和长发是邻居本人的	粉色连衣裙的女人	T
他睡在别人的家里了	洗衣机	F
火柴燃烧过	半根火柴	F
老婆在闺蜜家里发现了什么秘密	闺蜜	T
我可能会受伤害	电梯	T
闺蜜做了坏事	闺蜜	T
他的尸体附近是不是有悬崖峭壁	半根火柴	F
男人是失足掉落悬崖	半根火柴	F
我认识死者	小红裙	T
男生曾经跳进过河里	水草	T
他亲人在海难中死了	海龟汤的故事	T
我杀了人正在伪造遗书	伪造	T
女士过去穿平底鞋	高跟鞋	N
小王滑下来看到了长大了的自己	滑梯	T
是多个人写的	伪造	F
男子遇到了尸体	新闻	T
照片里有我熟悉的东西	交换照片	T
我的房间里有别人	丢失的手机	T
售货员为了掩盖什么东西,所以让人以为打折	打折的零食	T
男友是他父母的孩子	见家长	T
火柴烧断了降落伞	半根火柴	F
尸体的死亡和红衣服有关	小红裙	T
男人是迷路了	半根火柴	F
他希望病好	隧道	T
他在餐厅喝的这碗汤里有人体组织	海龟汤的故事	F
侏儒用削尖的木头自杀的	马戏团	N
盲人用木屑垫脚	马戏团	F
他做了一个午夜列车的梦其实都是自己吓自己	午夜列车	F
我长得和他们儿子一样	见家长	F
女儿抑郁症了	日记	F
红色其实是凶兆	高跟鞋	F
电梯到了顶层还在上升	电梯	F
海龟汤放了致幻药物喝了会使人精神不由自己控制导致自杀	海龟汤的故事	F
因为一些原因我和男友不得不在两个家庭生活	见家长	T
船上出了事情我吃人肉存活	鱼	F
女孩挂在阳台上的	阳台上的女孩	T
女儿看电脑所以家里开销大	日记	F
托马斯和闺蜜在一起过	闺蜜	T
他背后有人	交换照片	T
行人是因为死刑犯的尸体捂鼻子	死刑犯跟恶魔	T
我是因为被感动到了才这么说的	1237	T
死刑犯许的愿望是吃螺蛳粉	死刑犯跟恶魔	F
照片内容很吓人	交换照片	T
死者是在我放学回来的时候死亡的	小红裙	F
我的脸上有特殊印记	见家长	F
老婆知道了托马斯的秘密	闺蜜	T
我杀了我的水手同事	鱼	F
有很多人在说同一句话	伪造	F
男人喜欢喝汤	海龟汤的故事	N
我有危险	阳台上的女孩	F
男子会死	午夜列车	T
这个人曾经是个盲人	隧道	T
电梯上升是有人摁了	电梯	F
我坐到了太平间	电梯	F
死刑犯躲在有味道的地方	死刑犯跟恶魔	F
我在家里找到手机发现手机被其他人用过说明我家有其他人来	丢失的手机	T
洗衣机启动会导致有人去世	洗衣机	F
麻烦指的是这句话永远不会消失	伪造	F
男生以为水草是人手	水草	F
我看到的小卖部老板不是原老板,所以不一定清楚价格	打折的零食	T
买鞋原因重要	高跟鞋	F
母亲死了	仪式	F
男子死了	新闻	F
火柴抓阄从热气球上摔下来摔死了	半根火柴	T
他去看的是身体上的病而不是心理疾病	隧道	T
这是两个人的对话	伪造	F
渔夫是故意说那句话的	水草	N
再过5分钟如果不出事故婆婆将满70岁	午夜列车	T
小明晴天按不到18,下雨天可以用伞按下18楼	十八楼	T
因为点燃火柴导致他死了	半根火柴	F
托马斯有网恋对象	闺蜜	F
他看的是失忆症	隧道	F
是自己的隐私照片	交换照片	F
我在家看见了什么不好的东西	丢失的手机	F
洗衣机的主人想伤害他	洗衣机	F
尸体是陌生人	小红裙	F
吵架是因为男人做的某些事	粉色连衣裙的女人	T
操作洗衣机的不是人	洗衣机	F
有人陷害我	伪造	F
托马斯和闺蜜真的是第一次见	闺蜜	F
是拾荒者开的洗衣机	洗衣机	F
小孩必须每天站在那里	滑梯	N
男子曾经搭载的热气球上有别人	半根火柴	T
小王看到的是和惊恐的小孩看到的相似的东西	滑梯	T
他自杀是因为看到了医院	隧道	F
曾经出海的时候把同事当成鱼吃掉了	鱼	F
女儿被拉去做网络水军过	日记	T
我杀过人	鱼	N
他遇到的麻烦是让别人失望	伪造	F
我当水手的时候把鱼当成了其他东西	鱼	F
他得了臆想症	隧道	F
列车在12:00会出事故	午夜列车	N
女子觉得男生考不上	条件	F
男孩捐献了他的遗体	条件	T
这个小红裙是姐姐穿过的	小红裙	F
红裙子跟诅咒有关	小红裙	F
男子出现在新闻里了	新闻	F
有人在楼上按电梯	电梯	T
是意外杀人	高跟鞋	T
我做了事让别人死了	伪造	T
女人就是隔壁的邻居本人	粉色连衣裙的女人	T
女儿为了买明星周边所以开销大	日记	T
新闻和男子的家里有关	新闻	F
告诉大家我就会死	视力	T
闺蜜和托马斯之前就认识	闺蜜	T
我有可能要出事	数数	T
他父母反对我们结婚是因为我未成年	见家长	F
他是跟别人抽签输了抽到半根火柴所以才死掉的	半根火柴	T
盲人家里没有木质家具	马戏团	F
之前这个地方死过对男生来说很重要的人	水草	T
启动洗衣机的人准备对拾荒者图谋不轨	洗衣机	F
我怕鲨鱼	鱼	N
阻止结婚是因为看见我的脸	见家长	T
我给我的手机打了电话	丢失的手机	T
男子觉得新闻里出现的人会伤害他	新闻	F
男人被女人诬陷了	伪造	F
女孩是开心的跟我打招呼	阳台上的女孩	N
那句话是只写给我看的	视力	F
火柴是男人自己的	半根火柴	N
男人在模仿别人的笔记	伪造	T
女孩的住址信息和1237有关	1237	F
婆婆可以预料到事故嘛	午夜列车	F
卖货者不是老板	打折的零食	T
这个男人是不是因为有精神方面的疾病才自杀	海龟汤的故事	F
我看到的那个女人是他妈	粉色连衣裙的女人	F
他对闺蜜家熟悉	闺蜜	T
小明家里有家人	十八楼	N
尸体是我的爸爸	小红裙	F
我毛骨悚然是因为他数的数跟我有区别	数数	F
女子是杂技团的	高跟鞋	T
我看见过死人	鱼	T
鞋子是杀人的凶器	高跟鞋	F
因为四五六是我和她还有她妈	1237	F
其实女孩站的阳台是我家	阳台上的女孩	F
男子的超能力是预知未来	午夜列车	F
男人死了很久了	半根火柴	N
对方模仿我以前说过的话	伪造	F
是他杀	高跟鞋	T
除了拾荒者外有第二个人在场	洗衣机	T
我在电梯开门的时候看到了谋杀	电梯	T
尸体我们都不认识	小红裙	F
我恢复视力是人为的	视力	F
女儿做的事情涉及虚拟货币	日记	F
他在天上	数数	F
父母坚决反对我们结婚交往跟我的家庭背景有关	见家长	T
穿红衣服和死亡有关系	小红裙	T
是他的妻子写的	伪造	F
他在数我的死亡倒计时	数数	F
家访时我知道了些什么	1237	T
热气球曾经超重了	半根火柴	T
他忍受不了侏儒的身份	马戏团	F
电梯上升时门开着	电梯	F
是由熟人杀的她	高跟鞋	T
第二天看到画的时候画和第一次看到的有变化	一幅画	T
男子发现新闻说有杀人狂	新闻	F
他的病是有关精神的	隧道	F
他点燃过火柴	半根火柴	F
电梯是正常运行的	电梯	T
餐厅喝的这碗汤的材料是海龟	海龟汤的故事	T
鱼以前导致过有人死亡	鱼	F
我被人盯上了	伪造	F
他受到了其他人的惊吓	隧道	F
我会死亡	伪造	N
盲人侏儒认为自己长高了	马戏团	T
男子是活的	一幅画	T
是鱼让我最后不做水手了	鱼	N
是拾荒者启动了洗衣机	洗衣机	F
邻居本人身体受伤	粉色连衣裙的女人	N
女儿沉迷投资	日记	F
我试图伪造些什么	伪造	T
这是一个人日记的内容	伪造	T
我杀了人	伪造	T
我在上学的时候碰到了杀人犯	小红裙	F
单亲家庭	1237	N
女孩学习成绩非常好	条件	N
女士是杂技团演员	高跟鞋	T
我有精神病	丢失的手机	F
电视里在播报杀人案	新闻	F
他数哪层哪层就死人	数数	F
电梯被楼上的人按了	电梯	T
托马斯在闺蜜家里做了某些行为让他老婆觉得他很不尊重闺蜜	闺蜜	F
故事里有别人	马戏团	T
木屑是他的双腿	马戏团	F
鱼饵的成分重要	鱼	T
男人自杀是因为他杀了人	海龟汤的故事	F
她的闺蜜和托马斯有私情	闺蜜	T
卖零食的人是嫌疑犯	打折的零食	T
女儿是沉迷于什么了	日记	T
在闺蜜家发现老公的物品	闺蜜	F
在电梯合上的瞬间看到杀人犯了	电梯	T
手机出现在我不可能去的地方	丢失的手机	F
画的位置很奇怪	一幅画	F
周围的木屑是他自己搞出来的	马戏团	F
男子能看见别人的年龄	午夜列车	F
456跟时间有关系	1237	T
他和同伴一起来的	海龟汤的故事	N
男子是因为意外事故死的	半根火柴	F
我头皮发麻是因为这幅画不对劲	一幅画	T
马戏团有时需要自制道具	马戏团	N
写这些话的人死了	伪造	F
网友在我床底	交换照片	T
死刑犯的愿望是这个世界变臭	死刑犯跟恶魔	F
启动洗衣机是为了掩盖杀人真相	洗衣机	T
我做水手的时候见过鱼吃人	鱼	T
小朋友分不清母亲到底多少岁	四岁的妈妈	F
我们住在同一栋楼	数数	F
画中人的位置改变了	一幅画	T
画中的男子还在	一幅画	F
男子听不到电视声音	新闻	F
电梯到了楼顶	电梯	F
洗衣机里面有证物	洗衣机	T
打折零食质量有问题	打折的零食	N
海龟汤是一种隐喻不是真的汤	海龟汤的故事	F
他的同伴为了给热气球减轻重量	半根火柴	T
汤是餐厅做的	海龟汤的故事	T
男友和我是亲人关系不可以近亲结婚	见家长	T
木屑是因为家具被改造了	马戏团	T
家里有4岁的人	四岁的妈妈	F
我感到惊恐是因为她妈妈的年龄	四岁的妈妈	F
照片内容很重要	交换照片	T
火柴本来是要烧毁东西的	半根火柴	F
男子想完整的去死	隧道	F
他在隧道里看到了尸体	隧道	F
有其他人	电梯	T
男子的同伴活着	半根火柴	N
我真的找到我的手机了	丢失的手机	T
父亲不同意母亲学舞蹈	仪式	F
他在伪造	伪造	T
他从热气球上摔下来的	半根火柴	T
小红裙不是裙子	小红裙	F
女儿就是我	日记	F
托马斯的老婆在她闺蜜家里发现了托马斯之前的出轨证据	闺蜜	T
这个人自杀是因为觉得病没治好	隧道	T
男人从骆驼上掉下来了	半根火柴	F
是因为超载必须下去一人	半根火柴	T
打电话找手机发现有人接电话	丢失的手机	T
鱼吃过我的爱人	鱼	N
我在小朋友家看到尸体了	四岁的妈妈	F
死刑犯希望自己遗臭万年	死刑犯跟恶魔	F
老婆闺蜜暗示她跟丈夫离婚	闺蜜	F
他眼睛是用别人眼睛治好的	隧道	F
母亲跟父亲去的是同一个地方	仪式	F
水草很像一个人的头发	水草	T
男子是从热气球上掉下来的	半根火柴	T
他选择到十五楼和到十八楼的日子和当天天气有关	十八楼	T
他老婆发现了托马斯的什么秘密	闺蜜	T
电梯异常,本该下降	电梯	F
我要去楼顶	电梯	F
照片里的是不是有什么让我害怕的东西	交换照片	T
我和男友是姐弟	见家长	F
男子乘坐的是热气球	半根火柴	T
餐厅的海龟汤是毒药	海龟汤的故事	N
重复发出的是声音的录音	伪造	F
男子看到自己似乎目睹了杀人过程	新闻	F
我踏入阳台会对我造成生命危险	阳台上的女孩	F
恶魔理解错了死刑犯的意思	死刑犯跟恶魔	F
男人想点燃什么	半根火柴	F
男人穿女人衣服被发现了	伪造	F
我看到了一个人被杀了	电梯	T
小朋友不是五岁她给她哥找女老师囚禁	四岁的妈妈	T
闺蜜是小三	闺蜜	T
男子能看到其他人看不到的东西	午夜列车	T
死的是老板	打折的零食	T
是因为电梯有问题	十八楼	F
离婚和出轨相关	闺蜜	T
手机打过电话	丢失的手机	T
我有生命危险	一幅画	N
男子有精神病	隧道	F
故事除了拾荒者还有别人	洗衣机	T
托马斯做错什么了	闺蜜	T
鱼饵是鱼的同类	鱼	F
我见过用人当诱饵钓鱼	鱼	T
我跟他父母长得很像	见家长	N
小朋友健忘	1237	F
他自己一个人来这家餐厅的	海龟汤的故事	N
水手对鱼过敏	鱼	F
他数数跟我的生命安全相关	数数	T
新闻在播报这名男子的死亡消息	新闻	F
男子被人杀了	半根火柴	T
这是我的日记	伪造	F
小朋友心理有问题	1237	F
托马斯出过轨	闺蜜	T
侏儒的死亡和他的眼盲有关	马戏团	T
这个故事还有第二个人	马戏团	T
母亲在保佑自己家庭	仪式	F
他觉得生活没希望了	隧道	T
这是他们的暗号	1237	F
病治好了脑子没治好	隧道	F
邻居真的是独居	粉色连衣裙的女人	T
他在读别人的遗书	伪造	F
他之前有自杀倾向嘛	海龟汤的故事	N
她妈妈会在3月死但7月是女孩生日	1237	F
别人不想让我去学校	电梯	T
我的肉被当成鱼饵	鱼	F
妈妈活着	1237	T
餐厅的海龟汤里除了海龟还有别的材料	海龟汤的故事	N
照片内容很诡异	交换照片	T
死刑犯的愿望是见见外面的太阳	死刑犯跟恶魔	F
这个人有心理疾病	隧道	F
我吃过人肉	鱼	N
男人的枪是他自己带的	海龟汤的故事	N
曾经有人和男人结伴来到这里	水草	T
男子之前在热气球上	半根火柴	T
他真的是纯靠猜猜对年龄的	午夜列车	F
拾荒者被杀了	洗衣机	F
母亲要给父亲惊喜	仪式	F
长发女人是真的女人	粉色连衣裙的女人	F
河里死过人	水草	T
毒死了	小红裙	F
托马斯是在闺蜜家暴露了自己的秘密	闺蜜	T
电梯通向的楼层存在	电梯	T
男子的行李被翻过	半根火柴	N
对面摆出打招呼姿势的是尸体	阳台上的女孩	T
妈妈确实认为123的下一个是7	1237	F
死的人是住小屋里的人	山顶	F
因为有一台电梯只能上15楼	十八楼	F
男友父母认识我的脸	见家长	T
托马斯老婆出轨	闺蜜	F
同事扔飞刀因为她变高了结果死了	高跟鞋	T
男友父母在我小的时候就见过我	见家长	T
是有人在学我说话	伪造	F
火柴已经点燃过了	半根火柴	F
小朋友的妈妈长着一张儿童的脸	四岁的妈妈	F
他们之前见过我的脸	见家长	T
画的内容本身是恐怖的	一幅画	F
画里的头发是真人的头发	一幅画	T
男生跳河是受到了什么刺激	水草	T
他是去沙漠玩的	半根火柴	T
他看到的店员是杀人犯	打折的零食	T
母亲转账给很多人	仪式	N
网友的照片在我熟悉的地方拍摄	交换照片	T
有人帮小明按按钮	十八楼	F
这个故事里一共只有两个人	粉色连衣裙的女人	F
闺蜜不喜欢托马斯	闺蜜	F
尸体是姐姐认识的人	小红裙	F
电梯上升的速度不正常	电梯	F
是鹦鹉	伪造	F
男子带着特殊任务坐车	午夜列车	F
再过五分钟全列车的人都要因为列车事故而死	午夜列车	F
手机是我找到的	丢失的手机	T
凶手发现我了	电梯	T
四岁是女人被囚禁的时间	四岁的妈妈	T
画里是活人	一幅画	T
她妈妈故意的这么教的	1237	T
和小朋友的家人有关系	1237	T
闺蜜和老婆关系很好	闺蜜	N
我曾目睹鱼吃掉我的伙伴	鱼	T
他以前是有出过海	海龟汤的故事	T
男子所干的工作是不合法的	新闻	F
洗衣机里面有东西	洗衣机	T
我和这家人有血缘关系	见家长	T
托马斯出轨闺蜜	闺蜜	T
他去15楼是因为没带雨伞按不到电梯键	十八楼	T
其实那个售货员是杀人犯假扮的	打折的零食	T
妈妈不认识4和5	1237	F
这双高跟鞋会导致女人被工作上的人杀死	高跟鞋	T
隧道是通往死亡世界	隧道	F
姐姐如果不送我小红裙尸体会出现	小红裙	F
男生出车祸了	条件	N
男生被大学录取了	条件	F
她的死是谋杀	高跟鞋	F
是我的妻子死亡	伪造	T
妈妈的病是绝症	1237	T
他在倒数	数数	N
这个故事有超自然因素	隧道	F
洗衣机的主人想拿回洗衣机	洗衣机	F
木屑是地板产生的	马戏团	F
是他杀	半根火柴	T
她家里一共有七个人	1237	N
死者想敲门求救但是在门开之前被凶手杀了	山顶	F
男子的死亡现场是伪造的	半根火柴	F
所有话都是一个人说的	伪造	T
新闻内容是有关谋杀的	新闻	F
盲人侏儒是不是在家里做了很多记号	马戏团	N
我和他们女儿长得一样	见家长	T
存在一种病必须要见光	隧道	F
女孩跟我打招呼是我的错觉	阳台上的女孩	T
信件的笔迹是同一个人写的	伪造	T
小朋友的妈妈是童养媳	四岁的妈妈	F
长发女人是男人的女儿	粉色连衣裙的女人	F
卖货者出现在新闻报导里了	打折的零食	T
我杀死了妻子	伪造	T
我见过鱼吃了我的伙伴	鱼	T
我一直被监视	阳台上的女孩	N
回家路上发生的事导致离婚的	闺蜜	F
电梯之所以上升是因为女孩被杀害前为了求救按了电梯按钮	电梯	T
他发现自己被绿了所以自杀	海龟汤的故事	F
热气球火被吹灭了	半根火柴	F
女孩其实站在自己家阳台	阳台上的女孩	F
小朋友妈妈有精神问题	四岁的妈妈	N
他以为是马戏团的道具实际上是锯子	马戏团	F
我落水过	鱼	N
火柴是别人放上去的	半根火柴	F
这件事和小明的年龄有关	十八楼	T
小朋友的妈妈是被迫生下她的	四岁的妈妈	N
楼上有坏人	电梯	T
这是回音	伪造	F
我是凶手	小红裙	F
同伴的死是我间接导致的	鱼	N
内容是写下来的	伪造	T
他的生活是否发生变故	海龟汤的故事	T
汤是服务员端上来的	海龟汤的故事	N
是男人在重复某个行为	伪造	T
我并没有去上学	小红裙	F
死亡跟红色有关系	高跟鞋	F
托马斯的妻子出轨了	闺蜜	F
男生想起了伴侣	水草	T
有人尾随我	电梯	F
男人不在画上	一幅画	T
第二天看到了自己	一幅画	F
有多个电梯	十八楼	N
汤是黑色的	海龟汤的故事	N
托马斯做了对不起老婆的事	闺蜜	T
我目睹船员自相残杀	鱼	N
我家访的时候没有见到女孩的妈妈	1237	F
我和男友的父母有亲缘关系	见家长	T
死者是被撞飞后坠落的	半根火柴	F
男友的父母见过我的脸	见家长	T
手机是不是一直在我身上	丢失的手机	F
小朋友的妈妈有数字识别障碍	1237	F
托马斯和老婆的闺蜜曾经有过联系	闺蜜	T
男人自己从热气球跳下来的	半根火柴	F
1237是再见的意思	1237	F
他看不见了听到声音就下车了	隧道	F
我杀了说话的人	伪造	F
摔东西的是邻居本人	粉色连衣裙的女人	N
女儿自愿花钱	日记	T
滑梯本身有问题	滑梯	T
新闻里报道的人物在他家里	新闻	F
小朋友的妈妈只能数到4	四岁的妈妈	F
画其实是镜子	一幅画	F
这个人误杀了死者	山顶	T
托马不是第一次去	闺蜜	T
他得的是黑暗恐惧症	隧道	F
她的职业必须穿高跟鞋	高跟鞋	N
电梯总是能到达十八楼	十八楼	T
画是不存在的而是其他东西	一幅画	T
他是为了假装自己全程都是爬楼梯上来的	十八楼	F
男人喝完海龟汤精神受到了打击	海龟汤的故事	T
男的成了解剖用的尸体	条件	T
凶手是因为小红裙而行凶的	小红裙	F
这是两个人分手时的对话	伪造	F
画中的男子做了什么让人头皮发麻的事情	一幅画	T
托马斯做了对不起老婆的事情	闺蜜	T
她晚上要去的地方不适合穿高跟鞋	高跟鞋	F
有人死了	1237	F
洗衣机里的人在动	洗衣机	F
盲人是在制作上吊用到的木凳所以满地都是木屑	马戏团	F
盲人侏儒家中周围的环境变了	马戏团	T
新政府会杀死能看见的人	视力	T
在这个故事里汤是重点	海龟汤的故事	T
妈妈要死了	1237	T
我之前遇到过海难被困住的时候朋友骗我吃鱼肉实际不是鱼肉	鱼	F
电梯下坠	电梯	F
男生是否活着	条件	F
我是超生的	见家长	T
手机出现在了不该出现的位置	丢失的手机	T
女孩很孤独	阳台上的女孩	N
母亲转账是为了交学费	仪式	F
小明能到18楼是和父母一起回家的时候	十八楼	F
我觉得鱼恶心	鱼	T
小明个子矮	十八楼	T
遇到的麻烦是指杀人被发现了	伪造	T
我在伪造证件	伪造	F
灾难真的让所有人变成了盲人	视力	T
这个故事里一共有三个人	粉色连衣裙的女人	T